









11111111111
11001011101
1C011001E11
1000C000001
10000010C01
1P000C00001
10100010C01
10001000101
11111111111












